GEOID,Name,Median_Hhold._Income_of_Residents_in_2012-16,Population_Density_in_2010,Poverty_Rate_in_2012-16,Total Population,Population 18 and Older,Population Under 18,White Alone,Black Alone,Asian Alone,Other Race Alone,Multi-Race,Hispanic,"White Alone, Non-Hispanic",Total Minority Population,Total Housing Units,Occupied Housing Units,Vacant Housing Units
18011810300,"Lebanon, IN",58759,93.68,0.056,6028,4868,1160,5488,69,40,85,346,295,5435,593,2573,2483,90
18011810601,"Whitestown, IN",77501,109.2,0.125,8163,5749,2414,6957,273,242,144,547,345,6879,1284,2988,2892,96
18011810603,"Zionsville, IN",110837,751.2,0.0169,0,0,0,0,0,0,0,0,0,0,0,0,0,0
18011810604,"Zionsville, IN",137462,888.5,0.0239,6486,4463,2023,5687,120,298,51,330,181,5650,836,2128,2074,54
18011810605,"Zionsville, IN",99611,962,0.0123,7083,5701,1382,5955,210,336,117,465,366,5897,1186,3424,3125,299
18011810700,"Lebanon, IN",64355,49.43,0.1187,5014,3906,1108,4560,100,69,69,216,90,4537,477,2121,1991,130
18057110100,"Noblesville, IN",61367,114.4,0.13,0,0,0,0,0,0,0,0,0,0,0,0,0,0
18057110300,"Westfield, IN",67641,160.9,0.1054,0,0,0,0,0,0,0,0,0,0,0,0,0,0
18057110401,"Westfield, IN",54895,380.3,0.073,4443,3343,1100,3628,54,42,409,310,633,3534,909,1792,1634,158
18057110403,"Westfield, IN",78386,1713,0.0663,0,0,0,0,0,0,0,0,0,0,0,0,0,0
18057110404,"Carmel, IN",101198,2690,0.0257,5309,3861,1448,4668,124,147,84,286,185,4625,684,1947,1902,45
18057110505,"Noblesville, IN",78958,733,0.0436,7344,5262,2082,6347,162,140,261,434,513,6210,1134,2562,2478,84
18057110506,"Noblesville, IN",84169,856.3,0.067,0,0,0,0,0,0,0,0,0,0,0,0,0,0
18057110507,"Noblesville, IN",100194,668.4,0.0241,0,0,0,0,0,0,0,0,0,0,0,0,0,0
18057110508,"Noblesville, IN",66540,922,0.0486,0,0,0,0,0,0,0,0,0,0,0,0,0,0
18057110509,"Noblesville, IN",64876,1089,0.0811,5469,4020,1449,4684,128,70,242,345,430,4606,863,2193,2062,131
18057110511,"Noblesville, IN",91348,1739,0.0305,5688,4204,1484,5215,50,52,54,317,191,5180,508,2073,2035,38
18057110600,"Noblesville, IN",48587,3386,0.1676,4175,3255,920,3505,278,53,78,261,218,3450,725,1911,1792,119
18057110700,"Noblesville, IN",40027,2341,0.1522,3402,2620,782,2897,79,19,143,264,219,2851,551,1577,1430,147
18057110804,"Fortville, IN",125073,726.6,0.0263,0,0,0,0,0,0,0,0,0,0,0,0,0,0
18057110805,"Hawthorn Hills, Fishers, IN",113362,2661,0.0342,7793,5722,2071,6586,254,407,105,441,254,6521,1272,2809,2716,93
18057110806,"Fishers, IN",92016,1963,0.0177,0,0,0,0,0,0,0,0,0,0,0,0,0,0
18057110807,"Summerfield, Fishers, IN",75562,1854,0.072,6481,4869,1612,4414,463,926,201,477,446,4332,2149,2868,2664,204
18057110808,"Fishers, IN",102096,2569,0.034,0,0,0,0,0,0,0,0,0,0,0,0,0,0
18057110809,"Fishers, IN",87213,2678,0.0657,0,0,0,0,0,0,0,0,0,0,0,0,0,0
18057110810,"Fishers, IN",71705,1584,0.0328,6832,5380,1452,5617,418,265,106,426,281,5558,1274,3274,3098,176
18057110811,"Fishers, IN",70455,1935,0.0265,4492,3693,799,3537,337,217,96,305,260,3475,1017,2128,2026,102
18057110812,"Sunblest, Fishers, IN",84339,2066,0.0351,6686,5124,1562,5318,230,443,232,463,486,5215,1471,2887,2770,117
18057110903,"Carmel, IN",139372,1641,0.0324,0,0,0,0,0,0,0,0,0,0,0,0,0,0
18057110904,"Carmel, IN",145943,2712,0.0019,4652,3397,1255,4022,75,250,27,278,162,3993,659,1579,1545,34
18057110905,"Carmel Arts & Design District, Carmel, IN",67923,1946,0.0723,3819,3105,714,3007,122,220,126,344,332,2963,856,2188,1980,208
18057110906,"Carmel, IN",113375,2898,0.0385,6774,4930,1844,5846,148,332,97,351,232,5789,985,2536,2448,88
18057110907,"Carmel, IN",154645,2544,0.0067,5358,3869,1489,4600,97,351,16,294,139,4553,805,1768,1740,28
18057110908,"Carmel, IN",112809,1793,0.0318,0,0,0,0,0,0,0,0,0,0,0,0,0,0
18057111001,"Carmel, IN",149489,1025,0.0091,0,0,0,0,0,0,0,0,0,0,0,0,0,0
18057111003,"Carmel, IN",105403,2386,0.0195,4726,3584,1142,4280,49,95,38,264,108,4255,471,1859,1797,62
18057111004,"Woodland Springs, Carmel, IN",106315,2223,0.0194,3014,2258,756,2493,107,189,32,193,113,2474,540,1125,1093,32
18057111006,"Indianapolis, IN",71477,1776,0.0596,4171,3291,880,3370,112,241,99,349,260,3315,856,1857,1753,104
18057111007,"Carmel, IN",50499,3381,0.1867,4030,3146,884,2884,234,274,204,434,510,2841,1189,1846,1675,171
18057111008,"Carmel, IN",55026,2052,0.0789,0,0,0,0,0,0,0,0,0,0,0,0,0,0
18057111101,"Carmel, IN",105502,1281,0.0129,3852,2820,1032,3229,120,231,56,216,135,3197,655,1454,1408,46
18057111102,"Carmel, IN",82234,1217,0.0602,0,0,0,0,0,0,0,0,0,0,0,0,0,0
18059410200,"McCordsville, IN",75212,352.1,0.0508,0,0,0,0,0,0,0,0,0,0,0,0,0,0
18059410900,"Greenfield, IN",86743,234.6,0.0178,0,0,0,0,0,0,0,0,0,0,0,0,0,0
18063210102,"Brownsburg, IN",86182,880.4,0.0166,0,0,0,0,0,0,0,0,0,0,0,0,0,0
18063210104,"Brownsburg, IN",92129,497.2,0.0207,0,0,0,0,0,0,0,0,0,0,0,0,0,0
18063210201,"Brownsburg, IN",55549,2300,0.0752,4591,3480,1111,3588,404,149,110,340,262,3547,1044,2196,1982,214
18063210202,"Brownsburg, IN",52061,2418,0.0371,0,0,0,0,0,0,0,0,0,0,0,0,0,0
18063210604,"Avon, IN",73170,1864,0.0439,0,0,0,0,0,0,0,0,0,0,0,0,0,0
18097310103,"Indianapolis, IN",109527,522,0.092,0,0,0,0,0,0,0,0,0,0,0,0,0,0
18097310104,"Indianapolis, IN",46218,1006,0.0991,3576,3208,368,2296,776,157,104,243,245,2252,1324,2339,2122,217
18097310105,"Indianapolis, IN",50403,1300,0.1053,3830,2985,845,1542,1583,107,298,300,435,1493,2337,1766,1709,57
18097310106,"Westchester Estates, Indianapolis, IN",36052,4399,0.0845,4161,3461,700,1574,1689,172,387,339,619,1496,2665,2429,2302,127
18097310108,"Indianapolis, IN",88879,1324,0.0423,3597,3081,516,2722,498,109,59,209,152,2700,897,1712,1627,85
18097310110,"Indianapolis, IN",49312,3947,0.0392,3125,2456,669,1086,1524,74,193,248,350,1033,2092,1623,1524,99
18097310111,"Eagle Cove, Indianapolis, IN",46780,3070,0.0949,3771,2999,772,1172,1920,69,297,313,514,1102,2669,1954,1810,144
18097310201,"Augusta Green, Indianapolis, IN",58327,1140,0.1027,4603,3454,1149,1424,2089,178,515,397,755,1368,3235,1838,1774,64
18097310203,"Fieldstone and Brookstone, Indianapolis, IN",41486,3732,0.262,5939,4287,1652,1720,2738,114,793,574,1299,1554,4385,2601,2468,133
18097310204,"Indianapolis, IN",56440,2471,0.1616,5281,3837,1444,965,3158,194,584,380,782,891,4390,1926,1876,50
18097310305,"Indianapolis, IN",33646,4535,0.2366,6588,4795,1793,952,3688,165,1249,534,1761,754,5834,2886,2676,210
18097310306,"Gateway West, Indianapolis, IN",28851,3054,0.3966,6924,4640,2284,724,4128,109,1340,623,1982,564,6360,2597,2461,136
18097310308,"Guion Lakes, Indianapolis, IN",54080,2666,0.1417,3679,2692,987,831,2179,114,293,262,495,752,2927,1378,1331,47
18097310309,"Indianapolis, IN",34946,4955,0.1776,3880,2822,1058,621,2610,89,295,265,414,562,3318,1824,1708,116
18097310310,"Liberty Creek North, Indianapolis, IN",54221,5427,0.0684,4550,3318,1232,1237,2252,133,509,419,758,1151,3399,1733,1682,51
18097310311,"Indianapolis, IN",64820,2801,0.054,5831,4228,1603,1455,3347,173,439,417,742,1341,4490,2039,1978,61
18097310312,"Indianapolis, IN",40736,4498,0.1662,6203,4722,1481,999,3759,170,851,424,1201,859,5344,3169,2914,255
18097320105,"Washington Township, Indianapolis, IN",52803,4236,0.1444,4528,3687,841,2576,1187,141,319,305,454,2525,2003,2367,2185,182
18097320106,"Washington Township, Indianapolis, IN",66289,2575,0.0674,2526,1885,641,1481,744,34,108,159,183,1454,1072,1135,1018,117
18097320107,"College Commons, Indianapolis, IN",85947,1489,0.0742,1808,1529,279,1487,153,45,37,86,84,1464,344,923,875,48
18097320108,"Washington Township, Indianapolis, IN",27280,5167,0.284,5546,4220,1326,1724,2753,155,510,404,793,1618,3928,2863,2585,278
18097320109,"Washington Township, Indianapolis, IN",50573,2441,0.1309,2578,2148,430,1915,247,198,55,163,124,1902,676,1251,1190,61
18097320202,"Washington Township, Indianapolis, IN",79905,1327,0.0874,4708,4036,672,4133,177,80,56,262,150,4095,613,2650,2219,431
18097320203,"Washington Township, Indianapolis, IN",42460,3559,0.1257,3087,2600,487,1963,497,144,227,256,374,1904,1183,1921,1790,131
18097320204,"Driftwood Hills, Indianapolis, IN",36438,2079,0.2643,0,0,0,0,0,0,0,0,0,0,0,0,0,0
18097320301,"Washington Township, Indianapolis, IN",70557,2549,0.0706,3413,2992,421,3007,192,41,51,122,108,2986,427,1939,1794,145
18097320303,"Washington Township, Indianapolis, IN",49235,5455,0.1214,3585,3073,512,1918,975,119,246,327,384,1856,1729,2224,2065,159
18097320304,"Washington Township, Indianapolis, IN",76252,2090,0.0439,0,0,0,0,0,0,0,0,0,0,0,0,0,0
18097320400,"Eastwood, Indianapolis, IN",40778,2155,0.0728,3228,2465,763,1934,897,53,119,225,228,1905,1323,1508,1338,170
18097320500,"Washington Township, Indianapolis, IN",50638,2532,0.1018,3121,2533,588,2400,406,66,76,173,169,2368,753,1599,1533,66
18097320600,"Washington Township, Indianapolis, IN",50457,2302,0.1473,2554,2121,433,2189,93,31,95,146,168,2147,407,1323,1220,103
18097320700,"Warfleigh, Indianapolis, IN",70892,3348,0.1105,2353,2075,278,2037,66,77,48,125,97,2006,347,1479,1353,126
18097320800,"Washington Township, Indianapolis, IN",122414,1210,0.0349,3225,2492,733,2925,77,74,34,115,75,2905,320,1350,1254,96
18097320901,"Washington Township, Indianapolis, IN",49543,2889,0.1456,5883,4760,1123,3513,1585,176,250,359,374,3467,2416,2725,2579,146
18097320902,"Washington Township, Indianapolis, IN",34892,5386,0.3197,4644,3346,1298,1330,2295,278,381,360,647,1243,3401,2041,1886,155
18097320903,"Washington Township, Indianapolis, IN",34508,5665,0.2504,4922,3275,1647,657,2612,178,1041,434,1435,550,4372,1963,1710,253
18097321001,"Guion Lakes, Indianapolis, IN",40954,1781,0.2193,2860,2177,683,860,1100,85,550,265,775,760,2100,1147,1073,74
18097321002,"Washington Township, Indianapolis, IN",60796,1541,0.1336,4657,3718,939,2365,1701,132,150,309,271,2307,2350,2124,1986,138
18097321100,"Highland-Kessler, Indianapolis, IN",56434,1017,0.1131,3631,2966,665,2093,1148,70,109,211,208,2053,1578,1699,1564,135
18097321200,"Meridian-Kessler, Indianapolis, IN",110912,4072,0.0596,5071,4037,1034,4518,126,84,50,293,166,4454,617,2396,2251,145
18097321300,"Broad Ripple, Indianapolis, IN",67953,5265,0.0933,2619,2370,249,2342,87,37,33,120,104,2309,310,1520,1463,57
18097321400,"Washington Township, Indianapolis, IN",64779,2713,0.0922,5364,4440,924,3961,892,95,113,303,242,3914,1450,2700,2556,144
18097321600,"Washington Township, Indianapolis, IN",49180,2589,0.145,5024,4111,913,2238,2188,97,152,349,270,2201,2823,2532,2392,140
18097321700,"Indianapolis, IN",49831,3708,0.0397,4183,3594,589,3441,320,52,114,256,215,3386,797,2269,2133,136
18097321800,"Meridian-Kessler, Indianapolis, IN",97392,5244,0.0388,3556,2842,714,3134,124,51,52,195,130,3095,461,1674,1569,105
18097321900,"Indianapolis, IN",101279,6364,0.1883,6431,5677,754,5332,468,151,198,282,312,5280,1151,1457,1342,115
18097322000,"Indianapolis, IN",39237,3574,0.2165,3422,2803,619,1502,1545,34,102,239,187,1467,1955,1872,1582,290
18097322100,"Meridian-Kessler, Indianapolis, IN",42346,6344,0.1881,2706,1965,741,1469,990,24,44,179,121,1433,1273,1173,1051,122
18097322200,"Oliver Johnson's Woods, Indianapolis, IN",60557,5789,0.1054,2139,1607,532,1536,409,37,30,127,73,1506,633,921,868,53
18097322300,"Meridian-Kessler, Indianapolis, IN",73270,6445,0.0796,2528,1994,534,2123,187,33,28,157,82,2091,437,1196,1131,65
18097322400,"Indianapolis, IN",38953,5345,0.1965,2964,2525,439,1799,715,46,156,248,239,1757,1207,1725,1598,127
18097322500,"Indianapolis, IN",25325,1853,0.3587,1651,1281,370,598,750,22,168,113,209,576,1075,951,828,123
18097322600,"Indianapolis, IN",21152,2797,0.4341,0,0,0,0,0,0,0,0,0,0,0,0,0,0
18097322700,"Devington, Indianapolis, IN",40016,2315,0.1487,2002,1661,341,355,1437,14,121,75,181,328,1674,926,854,72
18097330103,"Indianapolis, IN",48941,2392,0.0768,4436,3763,673,2957,742,153,220,364,469,2879,1557,2541,2314,227
18097330105,"Indianapolis, IN",51164,1844,0.1046,5344,4301,1043,3109,1383,163,259,430,471,3014,2330,2881,2566,315
18097330106,"Indianapolis, IN",29028,3751,0.2985,4354,3634,720,2087,1526,158,261,322,472,2008,2346,2834,2422,412
18097330107,"Eagle Nest, Indianapolis, IN",96479,1750,0.0304,5683,4669,1014,4633,439,158,84,369,291,4562,1121,2438,2373,65
18097330108,"Indianapolis, IN",116597,1572,0.0173,3665,2988,677,3093,253,110,43,166,86,3085,580,1516,1465,51
18097330109,"Indianapolis, IN",87018,2481,0.0458,4907,3985,922,3689,466,148,176,428,388,3600,1307,2125,2081,44
18097330202,"Indianapolis, IN",40238,2379,0.234,0,0,0,0,0,0,0,0,0,0,0,0,0,0
18097330203,"Feather Cove III, Indianapolis, IN",108468,2727,0.0341,5418,4343,1075,4478,436,146,30,328,166,4447,971,2134,2060,74
18097330204,"Indianapolis, IN",84795,1955,0.0816,6133,4575,1558,3194,2027,131,229,552,500,3111,3022,2227,2173,54
18097330206,"Lawrence Woods, Indianapolis, IN",87562,3346,0.0462,4695,3563,1132,3162,926,133,91,383,273,3100,1595,1787,1754,33
18097330208,"Bay Ridge, Indianapolis, IN",71844,2896,0.0487,2879,2326,553,2125,387,77,77,213,192,2094,785,1293,1242,51
18097330209,"Indianapolis, IN",61130,2317,0.0956,0,0,0,0,0,0,0,0,0,0,0,0,0,0
18097330401,"Indianapolis, IN",81660,2081,0.0426,5985,4475,1510,3910,1430,72,159,414,297,3881,2104,2319,2231,88
18097330500,"Devington, Indianapolis, IN",44028,2900,0.1798,6329,4967,1362,1637,3801,67,445,379,646,1553,4776,2790,2641,149
18097330600,"Indianapolis, IN",38878,5087,0.3331,5267,3848,1419,2303,1899,32,538,495,855,2155,3112,2315,2129,186
18097330700,"Indianapolis, IN",34905,4512,0.1892,0,0,0,0,0,0,0,0,0,0,0,0,0,0
18097330803,"Indianapolis, IN",24689,7955,0.4252,3638,2356,1282,469,2417,7,470,275,726,369,3269,1720,1266,454
18097330804,"Indianapolis, IN",24195,6896,0.4573,3671,2400,1271,552,1748,16,967,388,1545,295,3376,1526,1366,160
18097330805,"Lawrence, IN",22631,2317,0.4643,3089,2146,943,877,1605,13,350,244,612,752,2337,1512,1328,184
18097330806,"Indianapolis, IN",26820,6578,0.3456,4269,2900,1369,676,2093,19,1010,471,1497,501,3768,1746,1441,305
18097330900,"Devington, Indianapolis, IN",31273,5015,0.1414,5686,4094,1592,633,4057,51,546,399,800,548,5138,2499,2298,201
18097331000,"Devington, Indianapolis, IN",36012,4095,0.1798,4194,3187,1007,216,3497,12,265,204,357,194,4000,1764,1611,153
18097340108,"Indianapolis, IN",24432,5528,0.4557,3761,2577,1184,493,2191,39,777,261,1010,428,3333,1442,1355,87
18097340109,"Summerfield South, Indianapolis, IN",52617,3515,0.1463,0,0,0,0,0,0,0,0,0,0,0,0,0,0
18097340110,"Aspen Ridge, Indianapolis, IN",37717,6748,0.1041,0,0,0,0,0,0,0,0,0,0,0,0,0,0
18097340111,"Wayne, Indianapolis, IN",65276,2039,0.1082,3870,2916,954,1680,1542,62,282,304,434,1639,2231,1110,1085,25
18097340112,"Wayne, Indianapolis, IN",41078,3793,0.2098,5108,4225,883,2401,2048,53,200,406,422,2307,2801,2971,2777,194
18097340114,"Wayne, Indianapolis, IN",70301,2731,0.0572,4440,3435,1005,2938,928,54,210,310,387,2886,1554,1804,1756,48
18097340201,"Indianapolis, IN",38724,4222,0.3647,3676,2503,1173,958,1030,64,1271,353,1697,781,2895,1202,1150,52
18097340202,"Speedway, IN",33956,4347,0.2332,4830,3508,1322,2022,1772,167,494,375,729,1927,2903,2196,2056,140
18097340300,"Eagledale, Indianapolis, IN",28682,5995,0.4267,0,0,0,0,0,0,0,0,0,0,0,0,0,0
18097340400,"Eagledale, Indianapolis, IN",36344,4806,0.2048,4024,2756,1268,873,942,39,1696,474,2179,707,3317,1422,1324,98
18097340500,"Venerable Flackville, Indianapolis, IN",31143,3001,0.2419,4932,3986,946,1537,2783,86,298,228,416,1473,3459,2050,1849,201
18097340600,"Indianapolis, IN",30452,3308,0.2559,5274,3945,1329,1161,2668,71,988,386,1313,1060,4214,2243,2041,202
18097340700,"Indianapolis, IN",28709,2037,0.4985,4219,2911,1308,1232,1153,22,1448,364,1851,1045,3174,1552,1430,122
18097340800,"Speedway, IN",51983,3398,0.1867,1751,1429,322,1448,46,108,39,110,77,1420,331,866,793,73
18097340901,"Wayne, Indianapolis, IN",61853,2667,0.0947,4034,3002,1032,2074,1107,69,370,414,688,1964,2070,1473,1421,52
18097340902,"Speedway, IN",35712,4856,0.2612,0,0,0,0,0,0,0,0,0,0,0,0,0,0
18097350100,"Indianapolis, IN",26000,2083,0.2907,1390,1093,297,222,929,20,117,102,164,202,1188,773,611,162
18097350300,"Crown Hill, Indianapolis, IN",16623,7535,0.4456,2511,2039,472,621,1556,10,112,212,193,592,1919,1698,1418,280
18097350400,"Mapleton - Fall Creek, Indianapolis, IN",34317,4839,0.2668,2490,2021,469,846,1300,21,67,256,187,826,1664,1309,1103,206
18097350500,"Indianapolis, IN",20807,3462,0.378,2395,1713,682,154,1922,2,180,137,280,109,2286,1156,963,193
18097350600,"Devington, Indianapolis, IN",26746,4968,0.3321,4406,3441,965,312,3479,14,340,261,508,246,4160,2205,1851,354
18097350700,"Indianapolis, IN",22419,2311,0.3872,1566,1171,395,138,1083,2,193,150,292,103,1463,754,622,132
18097350800,"Indianapolis, IN",15163,3745,0.5701,2375,1520,855,140,1949,3,135,148,197,121,2254,1101,906,195
18097350900,"Mapleton - Fall Creek, Indianapolis, IN",33544,4649,0.2423,1687,1182,505,510,1011,10,42,114,102,468,1219,796,633,163
18097351000,"Indianapolis, IN",26831,5551,0.3936,2555,1898,657,805,1467,16,113,154,181,777,1778,1406,1076,330
18097351200,"Indianapolis, IN",20905,3294,0.5038,2381,1702,679,156,1886,4,196,139,254,125,2256,1316,961,355
18097351500,"Highland Vicinity, Indianapolis, IN",35473,4043,0.2826,2023,1558,465,653,1076,31,98,165,192,620,1403,1084,900,184
18097351600,"Fall Creek Place, Indianapolis, IN",51846,5035,0.1823,2293,1964,329,1387,590,76,66,174,129,1364,929,1320,1187,133
18097351700,"Reagan Park, Indianapolis, IN",33124,2474,0.3955,2642,2057,585,1018,1364,28,74,158,134,995,1647,1382,1125,257
18097351900,"Martindale-Brightwood, Indianapolis, IN",24071,4459,0.2956,2140,1719,421,105,1824,8,105,98,173,74,2066,1073,955,118
18097352100,"Martindale-Brightwood, Indianapolis, IN",23815,3456,0.3944,2121,1459,662,221,1387,2,344,167,420,185,1936,992,767,225
18097352300,"Indianapolis, IN",19751,1621,0.4716,1604,1141,463,183,1134,5,211,71,288,129,1475,736,596,140
18097352400,"Indianapolis, IN",30374,3550,0.3682,3056,2240,816,1185,1196,5,396,274,609,1095,1961,1446,1246,200
18097352800,"Martindale-Brightwood, Indianapolis, IN",25987,1357,0.237,1480,1110,370,280,1084,10,22,84,66,260,1220,824,711,113
18097353500,"Ransom Place, Indianapolis, IN",13087,2329,0.5321,2480,2242,238,962,696,621,55,146,163,894,1586,1441,1346,95
18097353600,"Indianapolis, IN",21311,1380,0.4327,2708,2172,536,697,1441,66,331,173,431,626,2082,1538,1244,294
18097360101,"Indianapolis, IN",14749,2472,0.5081,2571,1854,717,685,1454,12,243,177,356,633,1938,1336,1109,227
18097360102,"Indianapolis, IN",19896,2666,0.5271,2826,1971,855,328,2058,5,281,154,333,305,2521,1279,1105,174
18097360201,"Indianapolis, IN",28619,2087,0.2695,4162,2959,1203,1030,2297,15,508,312,624,974,3188,1772,1655,117
18097360202,"Indianapolis, IN",32423,2880,0.2719,3179,2243,936,747,1816,12,332,272,547,654,2525,1238,1099,139
18097360301,"Warren, Indianapolis, IN",38202,2869,0.1997,4167,2850,1317,1386,1642,25,641,473,1033,1243,2924,1591,1521,70
18097360302,"Indianapolis, IN",27454,1308,0.3829,2706,1825,881,587,1366,6,524,223,762,489,2217,1176,992,184
18097360401,"Warren, Indianapolis, IN",30628,5697,0.3244,6205,4303,1902,1168,4000,43,505,489,871,997,5208,2613,2453,160
18097360402,"Northeastwood, Indianapolis, IN",40175,1831,0.2768,2088,1474,614,402,1316,4,231,135,367,336,1752,769,719,50
18097360404,"Indianapolis, IN",35860,3673,0.3,0,0,0,0,0,0,0,0,0,0,0,0,0,0
18097360405,"Warren, Indianapolis, IN",42382,2932,0.1353,6760,4824,1936,1734,3956,64,492,514,753,1643,5117,2658,2541,117
18097390500,"Indianapolis, IN",26673,1721,0.3864,2450,1804,646,325,1803,9,167,146,240,302,2148,1301,1032,269
18097390600,"Lawrence, IN",36660,833.1,0.2156,0,0,0,0,0,0,0,0,0,0,0,0,0,0
